NO ./path_to_the_north_texture
SO ./path_to_the_south_texture
EA ./path_to_the_east_texture
WE ./path_to_the_west_texture


F 220,100,0
C 225,30,0





111111111 11111111111
110000010100000000011
110000000000000000011
110000000000000000011
110000000N00000000011
110000000100000000111
111111111 11111111111